######   B
###### ###
### ## ###
### ## ###
### ## ###
##     ###
A   # ####
